MMMMMMMMMMMMMMMMMMMMMMMMMMMMMMMM
MTRTTTTTTTTTTTTTTTTTTTTTTTTTTTTM
MTTTTTTTTTTTTTTTTTTTTTTTTTTTTTTM
MTTTTTTTTTTTTTTTTTTTTTTTTTTTTTTM
MTTTTTTTTTTTTTTTTRTTTTTTTTTTTTTM
MTTTTTTTTTTTTTTTTTTTTTTTTTTTTTTM
MTTTTTTTTTTTTTTTTDTTTTTTTTTTTTTM
MTTTTTTTTTTTTTTTTTTTTTTTTTTTTTTM
MTTTTTTTTTTTTTTTTTTTTTRTTTTTTTTM
MMMMMMMMMMMMMMMMMMMMMRRMMMMMMMMM
MTTTTTTTTTTTTTTTTTTTTTTTTTTTTTTM
MTTTTTTTTDTTTTTTTTTTTTTTTTTTTTTM
MTTTTTTTTTTTTTTTTTTTTTTTTTTTTTTM
MTTTTTTTTTTTTTTTTTTTTTTTTTTTTTTM
MTTPTTTTTTTTTTTTTTTTTTTTTTTTTTTM
MMMMMMMMMMMMMMMMMMMMMMMMMMMMMMMM