MMMMMMMMMMMMMMMMMMMMMMMMMMMMMMMM
MTDTTTTTTTTTTTTTTTTTTTTTTTTTTTTM
MTTTTTTTTTTTTTTTTTTTTTTTTTTTTTTM
MMMMMMMMMMMMMMMMMMMMMMRRMMMMMMMM
MTTTTTTTTTTTTTTTTTTTTTTTTTTTTTTM
MTTTTTTTTTTTTTTTTTTTTTTDTTTTTTTM
MMMMMMMMMRRMMMMMMMMMMMMMMMMMMMMM
MTTTTTTTTTTTTTTTTTTTTTTTTTTTTTTM
MTTTTTTTTTDTTTTTTTTTTTTTTTTTTTTM
MMMMMMMMMMMMMMMMMRRMMMMMMMMMMMMM
MTTTTTTTTTTTTTTTTTTTTTTTTTTTTTTM
MTTTTTTTTDTTTTTTTTTTTTTTTTTTTTTM
MMMMMMMMMMMMMMMMMMMMMMMMMMMMMRRM
MTTTTTTTTTTTTTTTTTTTTTTTTTTTTTTM
MPTTTTTTTTTTTTTTTTTTTTTTTTTTTTTM
MMMMMMMMMMMMMMMMMMMMMMMMMMMMMMMM